111111111111
1P1C000100E1
101000C10001
100000000001
101111100001
10C00C1C0001
100010110001
1C0C100000C1
111111111111
