1111111111111
1100000100E10
1P10000000110
1011000000000
1011111000011
1001001000011
1000101101011
1000100001011
100010000C011
1111111111111
